##############################
# .............              #
# ################  ##########
#                            #
#   ##### #########          #
#       # #                  #
#                            #
##############################